
111111111111111111
100100C0000C000001
1C0001111100011101
1P0011E000001111C1
111111111111111111