1111111111111
1001000000001
1000011111001
1110011111101
1P0011E0000C1
1111111111111